# http://www.omniglot.com/writing/acehnese.htm
# https://en.wikipedia.org/wiki/Acehnese_language

::NFC;
::Lower;

a → a ;
b → b ;
ch → cʰ ;
c → c ;
dh → dʱ ;
d → d ;
eu → ɯ ;
e → ə ;
é → e ;
è → ɛ ;
ë → ə ;
#f → f ;
f → pʰ ;
gh → gʱ ;
g → g ;
h → h ;
i → i ;
jh → ɟʱ ;
j → ɟ ;
kh → kʱ ;
k } [$] → ʔ ;
k → k ;
lh → lʱ ;
l → l ;
mb → mᵇ ;
m → m ;
nd → nᵈ ;
ngg → ŋg ;
ng → ŋ ;
nj → ɳʲ ;
ny → ɲ ;
n → n ;
o → ɔ ;
ô → o ;
ö → ʌ ;
ph → pʰ ;
p → p ;
qh → kʱ ;
q } [$] → ʔ ;
q → k ;
rh → rʰ ;
r → r ;
sh → ʃ ;
s → s ;
th → t̺ʰ ;
t → t̺ ;
u → u ;
#v → v ;
v → bh ;
w → w ;
x → ks ;
y → j ;
#z → z ;
z → dʱ ;
