# https://www.omniglot.com/writing/twi.htm

::NFC;
::Lower;

a → ɑ ;
b → b ;
dw { i → dʑʷ ;
dw → dʒ ;
d → d ;
e → e ;
ɛ → ɛ ;
f → f ;
gy { i → dʑ ;
gw → gʷ ;
g → g ;
hw { i → çʷ ;
hy { i → ç ;
hw → hʷ ;
h → h ;
i → i ;
ky { i → tɕʰ ;
kw → kʰ ;
k → k ;
l → l ;
m → m ;
ngi → ɲĩ ;
ng → ŋː ;
nw → ŋŋʷ ;
nu → ɲʷĩ ;
nnyi → ɲːĩ ;
nyi → ɲːĩ ;
n → n ;
o → o ;
ɔ → ɔ ;
p → pʰ ;
r → r ;
s → s ;
t { i → t ;
tw { i → tɕʷ ;
t → tʰ ;
w { i → ɥ ;
w → w ;

