अंगूठी	اَن٘گُوْٹھِی	انگوٹھی
अंगूर	اَن٘گُوْر	انگور
अंगोला	اَن٘گوْلا	انگولا
अंग्रेज़	اَن٘گْریْز	انگریز
अंजीर	اَن٘جِیْر	انجیر
अंटार्कटिका	اَن٘ٹارْکٹِکا	انٹارکٹکا
अंडा	اَن٘ڈا	انڈا
अक्तूबर	اَکْتُوْبر	اکتوبر
अक्रा	اَکْرا	اکرا
अक्षत	اَکْشت	اکشت
अख़रोट	اَخروْٹ	اخروٹ
अगरतला	اَگرتلا	اگرتلا
अगस्त	اَگسْت	اگست
अचार	اَچار	اچار
अच्छा	اَچّھا	اچھا
अछनेरा	اَچھنیْرا	اچھنیرا
अजमेर	اَجمیْر	اجمیر
अझ़दहा	اَژدہا	اژدہا
अटक	اَٹک	اٹک
अटलांटिस	اَٹلان٘ٹِس	اٹلانٹس
अण्डा	اَنْڈا	انڈا
अण्डोरा	اَنْڈوْرا	انڈورا
अदरक	اَدرک	ادرک
अनन्तनाग	اَننْتناگ	اننتناگ
अनार	اَنار	انار
अनारकली	اَنارکلِی	انارکلی
अप्रैल	اَپْرَیْل	اپریل
अप्सरा	اَپْسرا	اپسرا
अभिलाष	اَبھِلاش	ابھلاش
अमरनाथ	اَمرناتھ	امرناتھ
अमरावती	اَمراوتِی	امراوتی
अमरेली	اَمریْلِی	امریلی
अमलतास	اَملتاس	املتاس
अमापा	اَماپا	اماپا
अमाया	اَمایا	امایا
अमीर	اَمِیْر	امیر
अमृत	اَمْرِت	امرت
अमृतसर	اَمْرِتسر	امرتسر
अमेठी	اَمیْٹھِی	امیٹھی
अयोध्या	اَیوْدھْیا	ایودھیا
अराक	اَراک	اراک
अरूबा	اَرُوْبا	اروبا
अर्थ	اَرْتھ	ارتھ
अर्दकान	اَرْدکان	اردکان
अलमाती	اَلماتِی	الماتی
अलसी	اَلسِی	السی
अलागोआस	اَلاگوْاس	الاگواس
अलाबामा	اَلاباما	الاباما
अलास्का	اَلاسْکا	الاسکا
अल्बर्टा	اَلْبرْٹا	البرٹا
अल्बानिया	اَلْبانِیا	البانیا
अल्मादेन	اَلْمادیْن	المادین
अवतार	اَوتار	اوتار
अस्सी	اَسِّی	اسی
अहरौरा	اَہرَوْرا	اہرورا
अहवाज़	اَہواز	اہواز
अहिंसा	اَہِن٘سا	اہنسا
आँख	آن٘کھ	آنکھ
आओ	آؤ	آؤ
आक़ा	آقا	آقا
आग	آگ	آگ
आगे	آگے	آگے
आचे	آچے	آچے
आड़ू	آڑُو	آڑو
आतिश	آتِش	آتش
आना	آنا	آنا
आम	آم	آم
आयत	آیت	آیت
आरज़ू	آرزُو	آرزو
आर्कटिक	آرْکٹِک	آرکٹک
आर्मीनिया	آرْمِیْنِیا	آرمینیا
आर्य	آرْیہ	آریہ
आलू	آلُو	آلو
आलोक	آلوْک	آلوک
आसनसोल	آسنسوْل	آسنسول
इंडिया	اِن٘ڈِیا	انڈیا
इंडियाना	اِن٘ڈِیانا	انڈیانا
इंडियानापोलिस	اِن٘ڈِیاناپوْلِس	انڈیاناپولس
इंडोनेशिया	اِن٘ڈوْنیْشِیا	انڈونیشیا
इक़बाल	اِقبال	اقبال
इटारसी	اِٹارسِی	اٹارسی
इतिहास	اِتِہاس	اتہاس
इदलिब	اِدلِب	ادلب
इन्तर्नास्योनाल	اِنْترْناسْیوْنال	انترناسیونال
इन्दौर	اِنْدَوْر	اندور
इल्तुतमिश	اِلْتُتمِش	التتمش
इस	اِس	اس
इस्लाम	اِسْلام	اسلام
ईंधन	اِیْن٘دھن	ایندھن
ईक्वाडोर	اِیْکْواڈوْر	ایکواڈور
ईख	اِیْکھ	ایکھ
ईरान	اِیْران	ایران
ईर्षावान	اِیْرْشاوان	ایرشاوان
ईवान	اِیْوان	ایوان
ईसप	اِیْسپ	ایسپ
ईस्टर	اِیْسْٹر	ایسٹر
उंगली	اُن٘گلِی	انگلی
उच	اُچ	اچ
उतार	اُتار	اتار
उत्तराखण्ड	اُتّراکھنْڈ	اتراکھنڈ
उदगीर	اُدگِیْر	ادگیر
उदमूर्तिया	اُدمُوْرْتِیا	ادمورتیا
उरण	اُرن	ارن
उर्दू	اُرْدُو	اردو
ऊँट	اُوْن٘ٹ	اونٹ
ऊख	اُوْکھ	اوکھ
ऊन	اُوْن	اون
ऊफ़ा	اُوْفا	اوفا
ऊषा	اُوْشا	اوشا
ऋग्वेद	رِگْویْد	رگوید
ए	اے	اے
एक	ایْک	ایک
एकड़	ایْکڑ	ایکڑ
एडिनबरा	ایْڈِنبرا	ایڈنبرا
एथलेटिक्स	ایْتھلیْٹِکْس	ایتھلیٹکس
एसेक्स	ایْسیْکْس	ایسیکس
ऐ	اَے	اے
ऐमिनैम	اَیْمِنَیْم	ایمنیم
ऐम्स्टर्डैम	اَیْمْسْٹرْڈَیْم	ایمسٹرڈیم
ऐरोली	اَیْروْلِی	ایرولی
ऐसा	اَیْسا	ایسا
ऑक्लैण्ड	آکْلَیْنْڈ	آکلینڈ
ऑक्साइड	آکْسائڈ	آکسائڈ
ऑक्सीजन	آکْسِیْجن	آکسیجن
ऑस्ट्रिया	آسْٹْرِیا	آسٹریا
ऑस्ट्रेलिया	آسْٹْریْلِیا	آسٹریلیا
ओक्लाहोमा	اوْکْلاہوْما	اوکلاہوما
ओखली	اوْکھلِی	اوکھلی
ओज़ोन	اوْزوْن	اوزون
ओटावा	اوْٹاوا	اوٹاوا
ओपेक	اوْپیْک	اوپیک
ओब्लास्त	اوْبْلاسْت	اوبلاست
ओलोमौक	اوْلوْمَوْک	اولوموک
ओश	اوْش	اوش
ओसाका	اوْساکا	اوساکا
ओस्लो	اوْسْلو	اوسلو
कचनार	کچنار	کچنار
कटक	کٹک	کٹک
कटनी	کٹنِی	کٹنی
कथक	کتھک	کتھک
कथा	کتھا	کتھا
कनिष्क	کنِشْک	کنشک
कपास	کپاس	کپاس
कबूतर	کبُوْتر	کبوتر
कमलेश्वर	کملیْشْور	کملیشور
कम्पाला	کمْپالا	کمپالا
कम्बोडिया	کمْبوْڈِیا	کمبوڈیا
करनाल	کرنال	کرنال
करबला	کربلا	کربلا
कराची	کراچِی	کراچی
कराटे	کراٹے	کراٹے
कराड	کراڈ	کراڈ
करेला	کریْلا	کریلا
करोड़	کروْڑ	کروڑ
कर्जत	کرْجت	کرجت
कर्नाटक	کرْناٹک	کرناٹک
कर्मान	کرْمان	کرمان
कलाई	کلائِی	کلائی
कवर्धा	کورْدھا	کوردھا
कशमोर	کشموْر	کشمور
कश्मीर	کشْمِیْر	کشمیر
कसारा	کسارا	کسارا
क़ानूनी	قانُوْنِی	قانونی
क़ुल्फ़ी	قُلْفِی	قلفی
कांगो	کان٘گو	کانگو
कांजी	کان٘جِی	کانجی
काकोरी	کاکوْرِی	کاکوری
काजू	کاجُو	کاجو
काठगोदाम	کاٹھگوْدام	کاٹھگودام
काठियावाड़	کاٹھِیاواڑ	کاٹھیاواڑ
कान	کان	کان
काफ़िरिस्तान	کافِرِسْتان	کافرستان
काबुल	کابُل	کابل
कारगिल	کارگِل	کارگل
कारतूस	کارتُوْس	کارتوس
कार्डिफ़	کارْڈِف	کارڈف
कालपी	کالپِی	کالپی
कासगंज	کاسگن٘ج	کاسگنج
काहलों	کاہلوْں	کاہلوں
किताबें	کِتابیْں	کتابیں
किन्शासा	کِنْشاسا	کنشاسا
किसान	کِسان	کسان
कीनिया	کِیْنِیا	کینیا
कुप्पम	کُپّم	کپم
कुरनूल	کُرنُوْل	کرنول
कुर्ला	کُرْلا	کرلا
कुलटूरवावेन	کُلٹُوْرواویْن	کلٹورواوین
कुवैत	کُوَیْت	کویت
कूलम्ब	کُوْلمْب	کولمب
कृष्ण	کْرِشْن	کرشن
केंटन	کیْن٘ٹن	کینٹن
केक	کیْک	کیک
केन्टकी	کیْنْٹکِی	کینٹکی
केला	کیْلا	کیلا
केसरी	کیْسرِی	کیسری
कैंडी	کَیْن٘ڈِی	کینڈی
कैण्टन	کَیْنْٹن	کینٹن
कैण्डेला	کَیْنْڈیْلا	کینڈیلا
कैथल	کَیْتھل	کیتھل
कैननबरी	کَیْننبرِی	کیننبری
कैनबरा	کَیْنبرا	کینبرا
कैफ़ीन	کَیْفِیْن	کیفین
कैलगरी	کَیْلگرِی	کیلگری
कैल्विन	کَیْلْوِن	کیلون
कैसे	کَیْسے	کیسے
कोई	کوْئِی	کوئی
कोटली	کوْٹلِی	کوٹلی
कोट्टायम	کوْٹّایم	کوٹایم
कोबाल्ट	کوْبالْٹ	کوبالٹ
कोबे	کوْبے	کوبے
कोलम्बिया	کوْلمْبِیا	کولمبیا
कौआ	کَوْا	کوا
कौशाम्बी	کَوْشامْبِی	کوشامبی
क्या	کْیا	کیا
क्यूबा	کْیُوْبا	کیوبا
क्यूबेक	کْیُوْبیْک	کیوبیک
क्यूशू	کْیُوْشُو	کیوشو
क्योटो	کْیوْٹو	کیوٹو
क्लासिक	کْلاسِک	کلاسک
क्वार्क	کْوارْک	کوارک
खजूर	کھجُوْر	کھجور
खतौली	کھتَوْلِی	کھتولی
खरड़	کھرڑ	کھرڑ
खरोंचना	کھروْن٘چنا	کھرونچنا
ख़त्म	ختْم	ختم
ख़याल	خیال	خیال
ख़ान	خان	خان
ख़ाबारोव्स्क	خاباروْوْسْک	خابارووسک
ख़ीवा	خِیْوا	خیوا
ख़ुजन्द	خُجنْد	خجند
ख़ोक़न्द	خوْقنْد	خوقند
ख़ोस्त	خوْسْت	خوست
खाँदवारी	کھان٘دوارِی	کھاندواری
खाद	کھاد	کھاد
खासी	کھاسِی	کھاسی
खिलौना	کھِلَوْنا	کھلونا
खीरा	کھِیْرا	کھیرا
खोपोली	کھوْپوْلِی	کھوپولی
गंगा	گن٘گا	گنگا
गंधक	گن٘دھک	گندھک
गङ्गा	گنْگا	گنگا
गणेश	گنیْش	گنیش
गधा	گدھا	گدھا
गन्ना	گنّا	گنا
गयाना	گیانا	گیانا
गरदेज़	گردیْز	گردیز
गरबा	گربا	گربا
गर्दन	گرْدن	گردن
ग़ज़नी	غزنِی	غزنی
ग़ज़ल	غزل	غزل
ग़म	غم	غم
ग़ुरूर	غُرُوْر	غرور
गांव	گان٘و	گانو
गांसू	گان٘سُو	گانسو
गाजर	گاجر	گاجر
गिटार	گِٹار	گٹار
गिनतारा	گِنتارا	گنتارا
गिरीडीह	گِرِیْڈِیْہ	گریڈیہ
गिलगित	گِلگِت	گلگت
गीत	گِیْت	گیت
गुजरात	گُجرات	گجرات
गुड़	گُڑ	گڑ
गुलज़ार	گُلزار	گلزار
गुलाब	گُلاب	گلاب
गूगल	گُوْگل	گوگل
गूगूश	گُوْگُوْش	گوگوش
गैण्डा	گَیْنْڈا	گینڈا
गोंडवाना	گوْن٘ڈوانا	گونڈوانا
गोआ	گوْا	گوا
गोइयास	گوْئیاس	گوئیاس
गोकुल	گوْکُل	گوکل
गोधरा	گوْدھرا	گودھرا
गोली	گوْلِی	گولی
गोहाना	گوْہانا	گوہانا
ग्राम	گْرام	گرام
ग्रेनाइट	گْریْنائٹ	گرینائٹ
ग्रेनाडा	گْریْناڈا	گریناڈا
ग्लासगो	گْلاسگو	گلاسگو
ग्लूकोज़	گْلُوْکوْز	گلوکوز
ग्वादर	گْوادر	گوادر
घड़ी	گھڑِی	گھڑی
घाना	گھانا	گھانا
घुटना	گھُٹنا	گھٹنا
घुमन	گھُمن	گھمن
घोड़ा	گھوْڑا	گھوڑا
चकवाल	چکوال	چکوال
चकाला	چکالا	چکالا
चकोर	چکوْر	چکور
चग़चरान	چغچران	چغچران
चना	چنا	چنا
चमन	چمن	چمن
चम्पावत	چمْپاوت	چمپاوت
चव्वन	چوّن	چون
चाँदी	چان٘دِی	چاندی
चांगचून	چان٘گچُوْن	چانگچون
चांगशा	چان٘گشا	چانگشا
चांद	چان٘د	چاند
चांसलर	چان٘سلر	چانسلر
चाए	چاۓ	چاۓ
चाड	چاڈ	چاڈ
चाबहार	چابہار	چابہار
चारीकार	چارِیْکار	چاریکار
चावल	چاول	چاول
चित्तूर	چِتُّوْر	چتور
चित्राल	چِتْرال	چترال
चियापास	چِیاپاس	چیاپاس
चिलास	چِلاس	چلاس
चिली	چِلِی	چلی
चीकू	چِیْکُو	چیکو
चीता	چِیْتا	چیتا
चुड़ैल	چُڑَیْل	چڑیل
चेंगदू	چیْن٘گدُو	چینگدو
चेचक	چیْچک	چیچک
चेल्याबिंस्क	چیْلْیابِن٘سْک	چیلیابنسک
चोंग्जिन	چوْن٘گْجِن	چونگجن
चौपाल	چَوْپال	چوپال
चौहान	چَوْہان	چوہان
जई	جئِی	جئی
जगह	جگہ	جگہ
जड़	جڑ	جڑ
जनवरी	جنورِی	جنوری
जमशेद	جمشیْد	جمشید
जमैका	جمَیْکا	جمیکا
जम्हूरियत	جمْہُوْرِیت	جمہوریت
जयपुर	جیپُر	جیپر
जर्मनी	جرْمنِی	جرمنی
जसपुर	جسپُر	جسپر
जहरोम	جہروْم	جہروم
ज़ंग	زن٘گ	زنگ
ज़रंज	زرن٘ج	زرنج
ज़ागान	زاگان	زاگان
ज़िंदगी	زِن٘دگِی	زندگی
ज़िम्बाब्वे	زِمْبابْوے	زمبابوے
ज़ीलैंड	زِیْلَیْن٘ڈ	زیلینڈ
ज़ैतून	زَیْتُوْن	زیتون
ज़्यूरिख़	زْیُوْرِخ	زیورخ
ज़्यूस	زْیُوْس	زیوس
जाट	جاٹ	جاٹ
जादू	جادُو	جادو
जापान	جاپان	جاپان
जामुन	جامُن	جامن
जावा	جاوا	جاوا
जिनेवा	جِنیْوا	جنیوا
जिबूती	جِبُوْتِی	جبوتی
जिहाद	جِہاد	جہاد
जीनान	جِیْنان	جینان
जीलिन	جِیْلِن	جیلن
जुगनू	جُگنُو	جگنو
जुड़वां	جُڑواں	جڑواں
जूँ	جُوْں	جوں
जूडो	جُوْڈو	جوڈو
जून	جُوْن	جون
जूनो	جُوْنو	جونو
जूल	جُوْل	جول
जेनोआ	جیْنوْا	جینوا
जैसलमेर	جَیْسلمیْر	جیسلمیر
जोंक	جوْن٘ک	جونک
जोहानिसबर्ग	جوْہانِسبرْگ	جوہانسبرگ
जौ	جَو	جو
ज्ञान	گْیان	گیان
ज्वार	جْوار	جوار
झंग	جھن٘گ	جھنگ
झाँसी	جھان٘سِی	جھانسی
झील	جھِیْل	جھیل
झूसी	جھُوْسِی	جھوسی
टकसाल	ٹکسال	ٹکسال
टक्कर	ٹکّر	ٹکر
टमाटर	ٹماٹر	ٹماٹر
टाइटैनिक	ٹائٹَیْنِک	ٹائٹینک
टाइम	ٹائم	ٹائم
टापू	ٹاپُو	ٹاپو
टार्ज़न	ٹارْزن	ٹارزن
टिटलागढ़	ٹِٹلاگڑھ	ٹٹلاگڑھ
टिम्बकटू	ٹِمْبکٹُو	ٹمبکٹو
टेनिस	ٹیْنِس	ٹینس
टेनेसी	ٹیْنیْسِی	ٹینیسی
टेफ़्रा	ٹیْفْرا	ٹیفرا
टैंगो	ٹَیْن٘گو	ٹینگو
टोंगा	ٹوْن٘گا	ٹونگا
टोगो	ٹوْگو	ٹوگو
टोयोटा	ٹوْیوْٹا	ٹویوٹا
ठंडा	ٹھن٘ڈا	ٹھنڈا
ठर्रा	ٹھرّا	ٹھرا
ठुमरी	ٹھُمرِی	ٹھمری
ठोस	ٹھوْس	ٹھوس
डबलिन	ڈبلِن	ڈبلن
डर	ڈر	ڈر
डरना	ڈرنا	ڈرنا
डर्बन	ڈرْبن	ڈربن
डाउनलोड	ڈاؤنلوْڈ	ڈاؤنلوڈ
डीघ	ڈِیْگھ	ڈیگھ
डीज़ल	ڈِیْزل	ڈیزل
डुनेडिन	ڈُنیْڈِن	ڈنیڈن
डेवन	ڈیْون	ڈیون
डोकरी	ڈوْکرِی	ڈوکری
ड्रम	ڈْرم	ڈرم
ढंग	ڈھن٘گ	ڈھنگ
ढूँढ़ना	ڈھُوْن٘ڑھنا	ڈھونڑھنا
तंग	تن٘گ	تنگ
तकबीर	تکبِیْر	تکبیر
तबरेज़	تبریْز	تبریز
तमनार	تمنار	تمنار
तमन्ना	تمنّا	تمنا
तम्बाकू	تمْباکُو	تمباکو
तराई	ترائِی	ترائی
तलवार	تلوار	تلوار
ताकिस्तान	تاکِسْتان	تاکستان
ताजिकिस्तान	تاجِکِسْتان	تاجکستان
ताण्डूर	تانْڈُوْر	تانڈور
तातारस्तान	تاتارسْتان	تاتارستان
तालव्य	تالوْیہ	تالویہ
तितली	تِتلِی	تتلی
तिरंगा	تِرن٘گا	ترنگا
तिलहर	تِلہر	تلہر
तिल्ली	تِلِّی	تلی
तुमसर	تُمسر	تمسر
तुर्किस्तान	تُرْکِسْتان	ترکستان
तुर्की	تُرْکِی	ترکی
तूवा	تُوْوا	تووا
तेईस	تیْئِیْس	تیئیس
तेनाली	تیْنالِی	تینالی
तेरह	تیْرہ	تیرہ
तेलंगाना	تیْلن٘گانا	تیلنگانا
तोप	توْپ	توپ
तोरख़म	توْرخم	تورخم
थेरवाद	تھیْرواد	تھیرواد
थैलीसीमिया	تھَیْلِیْسِیْمِیا	تھیلیسیمیا
दण्ड	دنْڈ	دنڈ
दमक	دمک	دمک
दस्तावेज़	دسْتاویْز	دستاویز
दही	دہِی	دہی
दाँत	دان٘ت	دانت
दाग़िस्तान	داغِسْتان	داغستان
दाढ़ी	داڑھِی	داڑھی
दादू	دادُو	دادو
दिक्तेल	دِکْتیْل	دکتیل
दिन	دِن	دن
दिया	دِیا	دیا
दिल	دِل	دل
दिल्ली	دِلِّی	دلی
दिसम्बर	دِسمْبر	دسمبر
दीमक	دِیْمک	دیمک
दुःख	دُکھ	دکھ
दुबई	دُبئِی	دبئی
दुर्ग	دُرْگ	درگ
दुर्गा	دُرْگا	درگا
दुर्योधन	دُرْیوْدھن	دریودھن
दूध	دُوْدھ	دودھ
देबल	دیْبل	دیبل
देवदार	دیْودار	دیودار
देवनागरी	دیْوناگرِی	دیوناگری
देवबन्द	دیْوبنْد	دیوبند
द्रौपदी	دْرَوْپدِی	دروپدی
धनबाद	دھنباد	دھنباد
धातु	دھاتُ	دھات
धूल	دھُوْل	دھول
धैर्य	دھَیْرْیہ	دھیریہ
धोथड़	دھوْتھڑ	دھوتھڑ
ध्रुपद	دھْرُپد	دھرپد
नंदूरबार	نن٘دُوْربار	نندوربار
नगमा	نگما	نگما
नगरकुरनूल	نگرکُرنُوْل	نگرکرنول
नजफ़	نجف	نجف
नज्द	نجْد	نجد
नफ़रत	نفرت	نفرت
नमाज़	نماز	نماز
नरवाना	نروانا	نروانا
नरौरा	نرَوْرا	نرورا
नर्गिस	نرْگِس	نرگس
नवम्बर	نومْبر	نومبر
नवाबशाह	نوابشاہ	نوابشاہ
नहर	نہر	نہر
नहावंद	نہاون٘د	نہاوند
नहीं	نہِیْں	نہیں
नांत	نان٘ت	نانت
नांदेड़	نان٘دیْڑ	ناندیڑ
नाइजर	نائجر	نائجر
नाक	ناک	ناک
नाख़ून	ناخُوْن	ناخون
नागालैण्ड	ناگالَیْنْڈ	ناگالینڈ
नागासाकी	ناگاساکِی	ناگاساکی
नागौर	ناگَوْر	ناگور
नाथद्वारा	ناتھدْوارا	ناتھدوارا
नान	نان	نان
नानचांग	نانچان٘گ	نانچانگ
नानजिंग	نانجِن٘گ	نانجنگ
नाननींग	ناننِیْن٘گ	ناننینگ
नानपारा	نانپارا	نانپارا
नाफ़	ناف	ناف
नारियल	نارِیل	ناریل
नारीन	نارِیْن	نارین
नाशपाती	ناشپاتِی	ناشپاتی
नासा	ناسا	ناسا
नासिक	ناسِک	ناسک
निकोटीन	نِکوْٹِیْن	نکوٹین
निचलौल	نِچلَوْل	نچلول
नित्य	نِتْیہ	نتیہ
नियोन	نِیوْن	نیون
निर्वाण	نِرْوان	نروان
निहारी	نِہارِی	نہاری
नीम	نِیْم	نیم
नीरो	نِیْرو	نیرو
नील	نِیْل	نیل
नीला	نِیْلا	نیلا
नीस	نِیْس	نیس
नेचर	نیْچر	نیچر
नेपाल	نیْپال	نیپال
नेपालगञ्ज	نیْپالگنْج	نیپالگنج
नेब्रास्का	نیْبْراسْکا	نیبراسکا
नेल्लोर	نیْلّوْر	نیلور
नेवला	نیْولا	نیولا
नेवाडा	نیْواڈا	نیواڈا
नैनीताल	نَیْنِیْتال	نینیتال
नैरोबी	نَیْروْبِی	نیروبی
नोकिया	نوْکِیا	نوکیا
नोवियाल	نوْوِیال	نوویال
नौरोज़	نَوْروْز	نوروز
नौशाद	نَوْشاد	نوشاد
न्यूटन	نْیُوْٹن	نیوٹن
पंजाब	پن٘جاب	پنجاب
पंजाबी	پن٘جابِی	پنجابی
पकोड़ा	پکوْڑا	پکوڑا
पगोडा	پگوْڈا	پگوڈا
पटवारी	پٹوارِی	پٹواری
पणजी	پنجِی	پنجی
पतंग	پتن٘گ	پتنگ
पदमिनी	پدمِنِی	پدمنی
पनवेल	پنویْل	پنویل
पपीता	پپِیْتا	پپیتا
पर्ल	پرْل	پرل
पलन्द्री	پلنْدْرِی	پلندری
पाई	پائِی	پائی
पाकदश्त	پاکدشْت	پاکدشت
पाकिस्तान	پاکِسْتان	پاکستان
पानी	پانِی	پانی
पारसी	پارسِی	پارسی
पाराना	پارانا	پارانا
पार्वती	پارْوتِی	پاروتی
पालक	پالک	پالک
पाश	پاش	پاش
पाशा	پاشا	پاشا
पासपोर्ट	پاسپوْرْٹ	پاسپورٹ
पिमलिको	پِملِکو	پملکو
पियानो	پِیانو	پیانو
पिलखुवा	پِلکھُوا	پلکھوا
पिशीन	پِشِیْن	پشین
पीतल	پِیْتل	پیتل
पीरानशहर	پِیْرانشہر	پیرانشہر
पीला	پِیْلا	پیلا
पीसा	پِیْسا	پیسا
पुखराज	پُکھراج	پکھراج
पुर्तगाल	پُرْتگال	پرتگال
पेरू	پیْرُو	پیرو
पैंजिया	پَیْن٘جِیا	پینجیا
पैरिस	پَیْرِس	پیرس
पोखरा	پوْکھرا	پوکھرا
पोतोसी	پوْتوْسِی	پوتوسی
पोर्शे	پوْرْشے	پورشے
पोलीनेशिया	پوْلِیْنیْشِیا	پولینیشیا
पोसाइडन	پوْسائڈن	پوسائڈن
प्याज़	پْیاز	پیاز
प्राकृत	پْراکْرِت	پراکرت
प्राग	پْراگ	پراگ
प्रीतम	پْرِیْتم	پریتم
प्लूटार्क	پْلُوْٹارْک	پلوٹارک
फल	پھل	پھل
फ़रवरी	فرورِی	فروری
फ़र्श	فرْش	فرش
फ़ाहियान	فاہِیان	فاہیان
फ़िजी	فِجِی	فجی
फ़िट्ज़रोविया	فِٹْزروْوِیا	فٹزروویا
फ़िल्म	فِلْم	فلم
फ़ूज्यान	فُوْجْیان	فوجیان
फ़्रान्स	فْرانْس	فرانس
फ़्रैंकफ़र्ट	فْرَیْن٘کفرْٹ	فرینکفرٹ
फूल	پھُوْل	پھول
बंगलौर	بن٘گلَوْر	بنگلور
बंगश	بن٘گش	بنگش
बंगाल	بن٘گال	بنگال
बंदरगाह	بن٘درگاہ	بندرگاہ
बकरी	بکرِی	بکری
बग़दाद	بغداد	بغداد
बचपन	بچپن	بچپن
बटेर	بٹیْر	بٹیر
बड़ा	بڑا	بڑا
बमाको	بماکو	بماکو
बरगद	برگد	برگد
बरेली	بریْلِی	بریلی
बरौनी	برَوْنِی	برونی
बर्न	برْن	برن
बर्फ़	برْف	برف
बर्फ़ी	برْفِی	برفی
बर्बर	برْبر	بربر
बर्मिंघम	برْمِن٘گھم	برمنگھم
बर्लिन	برْلِن	برلن
बलतसतान	بلتستان	بلتستان
बलती	بلتِی	بلتی
बलिया	بلِیا	بلیا
बलूचिस्तान	بلُوْچِسْتان	بلوچستان
बलोचिस्तान	بلوْچِسْتان	بلوچستان
बहनोई	بہنوْئِی	بہنوئی
बहराइच	بہرائچ	بہرائچ
बहामास	بہاماس	بہاماس
बहावलनगर	بہاولنگر	بہاولنگر
बाँस	بان٘س	بانس
बांसुरी	بان٘سُرِی	بانسری
बाकू	باکُو	باکو
बागेश्वर	باگیْشْور	باگیشور
बाज़ी	بازِی	بازی
बादल	بادل	بادل
बादशाह	بادشاہ	بادشاہ
बादाम	بادام	بادام
बाबिल	بابِل	بابل
बामयान	بامیان	بامیان
बायकोनूर	بایکوْنُوْر	بایکونور
बारबाडोस	بارباڈوْس	بارباڈوس
बारामती	بارامتِی	بارامتی
बारिश	بارِش	بارش
बारूद	بارُوْد	بارود
बाल	بال	بال
बाली	بالِی	بالی
बाहिया	باہِیا	باہیا
बिंग	بِن٘گ	بنگ
बिठूर	بِٹھُوْر	بٹھور
बिरयानी	بِریانِی	بریانی
बिलग्राम	بِلگْرام	بلگرام
बिलारी	بِلارِی	بلاری
बिल्ली	بِلِّی	بلی
बिल्हौर	بِلْہَوْر	بلہور
बिश्केक	بِشْکیْک	بشکیک
बिस्मार्क	بِسْمارْک	بسمارک
बिस्मिल	بِسْمِل	بسمل
बिहार	بِہار	بہار
बीकानेर	بِیْکانیْر	بیکانیر
बीज	بِیْج	بیج
बीजिंग	بِیْجِن٘گ	بیجنگ
बीदर	بِیْدر	بیدر
बीरजंद	بِیْرجن٘د	بیرجند
बुख़ारा	بُخارا	بخارا
बुज़कशी	بُزکشِی	بزکشی
बुटर	بُٹر	بٹر
बुटवल	بُٹول	بٹول
बुद्ध	بُدّھ	بدھ
बुर्ज	بُرْج	برج
बूशहर	بُوْشہر	بوشہر
बेग	بیْگ	بیگ
बेनिन	بیْنِن	بینن
बेमेतरा	بیْمیْترا	بیمیترا
बेलारूस	بیْلارُوْس	بیلاروس
बेलीज़	بیْلِیْز	بیلیز
बेलेम	بیْلیْم	بیلیم
बैंगन	بَیْن٘گن	بینگن
बैडमिंटन	بَیْڈمِن٘ٹن	بیڈمنٹن
बैसाखी	بَیْساکھِی	بیساکھی
बोइंग	بوْئن٘گ	بوئنگ
बोनसाई	بوْنسائِی	بونسائی
बोर्नियो	بوْرْنِیو	بورنیو
बोस्टन	بوْسْٹن	بوسٹن
ब्रह्मा	بْرہْما	برہما
ब्राज़ील	بْرازِیْل	برازیل
ब्रासीलिया	بْراسِیْلِیا	براسیلیا
ब्रिस्टल	بْرِسْٹل	برسٹل
ब्रिस्बेन	بْرِسْبیْن	برسبین
ब्रेमेन	بْریْمیْن	بریمین
भंडारा	بھن٘ڈارا	بھنڈارا
भक्कर	بھکّر	بھکر
भगवान	بھگوان	بھگوان
भदोही	بھدوْہِی	بھدوہی
भद्रक	بھدْرک	بھدرک
भद्राचलम	بھدْراچلم	بھدراچلم
भय	بھی	بھی
भलवाल	بھلوال	بھلوال
भारत	بھارت	بھارت
भावनगर	بھاونگر	بھاونگر
भिण्डी	بھِنْڈِی	بھنڈی
भीम	بھِیْم	بھیم
भीलवाड़ा	بھِیْلواڑا	بھیلواڑا
भीष्म	بھِیْشْم	بھیشم
भुवनेश्वर	بھُونیْشْور	بھونیشور
भुसावल	بھُساول	بھساول
भूटान	بھُوْٹان	بھوٹان
भूत	بھُوْت	بھوت
भेड़	بھیْڑ	بھیڑ
भेड़िया	بھیْڑِیا	بھیڑیا
भैंस	بھَیْن٘س	بھینس
भोपाल	بھوْپال	بھوپال
भोर	بھوْر	بھور
मंगोलिया	من٘گوْلِیا	منگولیا
मंचूरिया	من٘چُوْرِیا	منچوریا
मंडावा	من٘ڈاوا	منڈاوا
मंदसौर	من٘دسَوْر	مندسور
मई	مئِی	مئی
मकड़ी	مکڑِی	مکڑی
मकरान	مکران	مکران
मक्खन	مکّھن	مکھن
मछली	مچھلِی	مچھلی
मटर	مٹر	مٹر
मथुरा	متھُرا	متھرا
मदनपल्ली	مدنپلِّی	مدنپلی
मनीला	منِیْلا	منیلا
मरीवान	مرِیْوان	مریوان
मर्व	مرْو	مرو
मलावी	ملاوِی	ملاوی
मलेरिया	ملیْرِیا	ملیریا
मशहद	مشہد	مشہد
मसतूज	مستُوْج	مستوج
मस्जिद	مسْجِد	مسجد
महर	مہر	مہر
महाबलेश्वर	مہابلیْشْور	مہابلیشور
महाबाद	مہاباد	مہاباد
महाराष्ट्र	مہاراشْٹْر	مہاراشٹر
महू	مہُو	مہو
मांडवी	مان٘ڈوِی	مانڈوی
मांड्या	مان٘ڈْیا	مانڈیا
माझा	ماجھا	ماجھا
मानी	مانِی	مانی
मायावती	مایاوتِی	مایاوتی
मारियो	مارِیو	ماریو
मार्च	مارْچ	مارچ
माली	مالِی	مالی
माले	مالے	مالے
माल्टा	مالْٹا	مالٹا
मास्को	ماسْکو	ماسکو
माहे	ماہے	ماہے
मियांवाली	مِیان٘والِی	میانوالی
मियामी	مِیامِی	میامی
मिर्च	مِرْچ	مرچ
मिलियन	مِلِین	ملین
मिसवाक	مِسواک	مسواک
मिसौरी	مِسَوْرِی	مسوری
मीनार	مِیْنار	مینار
मील	مِیْل	میل
मुँह	مُن٘ہ	منہ
मुंगेर	مُن٘گیْر	منگیر
मुंबई	مُمبئِی	ممبئی
मुम्बई	مُمْبئِی	ممبئی
मुरीदके	مُرِیْدکے	مریدکے
मुल्ताई	مُلْتائِی	ملتائی
मुल्तान	مُلْتان	ملتان
मुसलमान	مُسلمان	مسلمان
में	میْں	میں
मेथी	میْتھِی	میتھی
मेरठ	میْرٹھ	میرٹھ
मेव	میْو	میو
मेवाड़	میْواڑ	میواڑ
मैं	مَیْں	میں
मैग्मा	مَیْگْما	میگما
मैटलैब	مَیْٹلَیْب	میٹلیب
मैडोना	مَیْڈوْنا	میڈونا
मैराथन	مَیْراتھن	میراتھن
मैसाचूसिट्स	مَیْساچُوْسِٹْس	میساچوسٹس
मैसूर	مَیْسُوْر	میسور
मैहर	مَیْہر	میہر
मोटापा	موْٹاپا	موٹاپا
मोण्टेवीडियो	موْنْٹیْوِیْڈِیو	مونٹیویڈیو
मोती	موْتِی	موتی
मोन्टाना	موْنْٹانا	مونٹانا
मोम	موْم	موم
मोरबी	موْربِی	موربی
मौसम	مَوْسم	موسم
म्यांमार	مْیان٘مار	میانمار
म्यान्मार	مْیانْمار	میانمار
यक्ष्मा	یکْشْما	یکشما
यज़ीदी	یزِیْدِی	یزیدی
यज़्द	یزْد	یزد
यमन	یمن	یمن
यरवदा	یرودا	یرودا
यहूदी	یہُوْدِی	یہودی
यांगून	یان٘گُوْن	یانگون
याक	یاک	یاک
यालाल	یالال	یالال
यूटाह	یُوْٹاہ	یوٹاہ
यूट्यूब	یُوْٹْیُوْب	یوٹیوب
यूनान	یُوْنان	یونان
यूनिक्स	یُوْنِکْس	یونکس
यूरेशिया	یُوْریْشِیا	یوریشیا
यूरो	یُوْرو	یورو
योकोहामा	یوْکوْہاما	یوکوہاما
योज़्गत	یوْزْگت	یوزگت
रंग	رن٘گ	رنگ
रक्षा	رکْشا	رکشا
रवाण्डा	روانْڈا	روانڈا
रश्त	رشْت	رشت
रस	رس	رس
राँची	ران٘چِی	رانچی
रांझणा	ران٘جھنا	رانجھنا
राकापोशी	راکاپوْشِی	راکاپوشی
राजकोट	راجکوْٹ	راجکوٹ
राजपूत	راجپُوْت	راجپوت
राजश्री	راجشْرِی	راجشری
राजस्थान	راجسْتھان	راجستھان
राजिम	راجِم	راجم
राम	رام	رام
रावलपिंडी	راولپِن٘ڈِی	راولپنڈی
रिट	رِٹ	رٹ
रीगा	رِیْگا	ریگا
रुस्तम	رُسْتم	رستم
रूपनगर	رُوْپنگر	روپنگر
रूस	رُوْس	روس
रेखा	ریْکھا	ریکھا
रेनडियर	ریْنڈِیر	رینڈیر
रेशम	ریْشم	ریشم
रोनाल्डो	روْنالْڈو	رونالڈو
रोम	روْم	روم
रोहड़ी	روْہڑِی	روہڑی
लंदन	لن٘دن	لندن
लकड़ी	لکڑِی	لکڑی
लखनऊ	لکھنؤ	لکھنؤ
लखना	لکھنا	لکھنا
लड़की	لڑکِی	لڑکی
लद्दाख़	لدّاخ	لداخ
लम्बाई	لمْبائِی	لمبائی
लहसुन	لہسُن	لہسن
लाइबेरिया	لائبیْرِیا	لائبیریا
लाओस	لاؤْس	لاؤس
लाख	لاکھ	لاکھ
लागोस	لاگوْس	لاگوس
लाटेक	لاٹیْک	لاٹیک
लातूर	لاتُوْر	لاتور
लाल	لال	لال
लावा	لاوا	لاوا
लाहीजान	لاہِیْجان	لاہیجان
लाहौर	لاہَوْر	لاہور
लियाओनिंग	لِیاؤْنِن٘گ	لیاؤننگ
लीची	لِیْچِی	لیچی
लीबिया	لِیْبِیا	لیبیا
लीमा	لِیْما	لیما
लील	لِیْل	لیل
लेसोथो	لیْسوْتھو	لیسوتھو
लोटा	لوْٹا	لوٹا
लोनावला	لوْناولا	لوناولا
लोम्बोक	لوْمْبوْک	لومبوک
लोरमी	لوْرمِی	لورمی
लोरी	لوْرِی	لوری
लोसल	لوْسل	لوسل
लोहा	لوْہا	لوہا
लोहाना	لوْہانا	لوہانا
लौंग	لَوْن٘گ	لونگ
लौकी	لَوْکِی	لوکی
ल्हासा	لْہاسا	لہاسا
वन	ون	ون
वर्जिल	ورْجِل	ورجل
वर्जीनिया	ورْجِیْنِیا	ورجینیا
वर्धा	ورْدھا	وردھا
वाख़ान	واخان	واخان
वापी	واپِی	واپی
विज्ञान	وِگْیان	وگیان
विदर्भ	وِدرْبھ	ودربھ
विनचेस्टर	وِنچیْسْٹر	ونچیسٹر
वियतनाम	وِیتنام	ویتنام
विलायत	وِلایت	ولایت
वीज़ा	وِیْزا	ویزا
वूहान	وُوْہان	ووہان
वृन्दावन	وْرِنْداون	ورنداون
वेद	ویْد	وید
वेनिस	ویْنِس	وینس
वेलिंग्टन	ویْلِن٘گْٹن	ویلنگٹن
वेल्लोर	ویْلّوْر	ویلور
वेस्टमिंस्टर	ویْسْٹمِن٘سْٹر	ویسٹمنسٹر
वैंकूवर	وَیْن٘کُوْور	وینکوور
वैतर्ना	وَیْترْنا	ویترنا
वोरार्लबर्ग	ووْرارْلبرْگ	وورارلبرگ
शंघाई	شن٘گھائِی	شنگھائی
शक्कर	شکّر	شکر
शबरग़ान	شبرغان	شبرغان
शब्द	شبْد	شبد
शराब	شراب	شراب
शहनाई	شہنائِی	شہنائی
शहर	شہر	شہر
शामली	شاملِی	شاملی
शाह	شاہ	شاہ
शिकागो	شِکاگو	شکاگو
शिरडी	شِرڈِی	شرڈی
शीराज़	شِیْراز	شیراز
शीशम	شِیْشم	شیشم
शूटर	شُوْٹر	شوٹر
शेख़	شیْخ	شیخ
शेनयांग	شیْنیان٘گ	شینیانگ
शेफ़ील्ड	شیْفِیْلْڈ	شیفیلڈ
श्यामा	شْیاما	شیاما
सकेसर	سکیْسر	سکیسر
सख्खर	سکّھر	سکھر
सड़क	سڑک	سڑک
सनंदज	سنن٘دج	سنندج
सपारकन	سپارکن	سپارکن
सपेरा	سپیْرا	سپیرا
सब्ज़ी	سبْزِی	سبزی
समर	سمر	سمر
समरक़न्द	سمرقنْد	سمرقند
समाज	سماج	سماج
सय्यद	سیّد	سید
सरोद	سروْد	سرود
सर्कस	سرْکس	سرکس
सर्बिया	سرْبِیا	سربیا
सहारनवास	سہارنواس	سہارنواس
सांगली	سان٘گلِی	سانگلی
साइबेरिया	سائبیْرِیا	سائبیریا
साईलैब	سائِیْلَیْب	سائیلیب
साकोली	ساکوْلِی	ساکولی
सारंगी	سارن٘گِی	سارنگی
साल्सा	سالْسا	سالسا
सिंचाई	سِن٘چائِی	سنچائی
सिंजार	سِن٘جار	سنجار
सिंध	سِن٘دھ	سندھ
सिक्किम	سِکِّم	سکم
सिख	سِکھ	سکھ
सिखमत	سِکھمت	سکھمت
सिडनी	سِڈنِی	سڈنی
सितम्बर	سِتمْبر	ستمبر
सितार	سِتار	ستار
सियालकोट	سِیالکوْٹ	سیالکوٹ
सियोल	سِیوْل	سیول
सिर	سِر	سر
सिरदर्द	سِردرْد	سردرد
सिर्त	سِرْت	سرت
सी	سِی	سی
सीमुर्ग़	سِیْمُرْغ	سیمرغ
सुहार्तो	سُہارْتو	سہارتو
सूडान	سُوْڈان	سوڈان
सूरज	سُوْرج	سورج
सेण्टियागो	سیْنْٹِیاگو	سینٹیاگو
सेब	سیْب	سیب
सेल्फ़ी	سیْلْفِی	سیلفی
सैमसंग	سَیْمسن٘گ	سیمسنگ
सोना	سوْنا	سونا
सोनी	سوْنِی	سونی
स्कर्दू	سْکرْدُو	سکردو
स्काइप	سْکائپ	سکائپ
स्पार्टा	سْپارْٹا	سپارٹا
स्लोवेनिया	سْلوْویْنِیا	سلووینیا
स्वात	سْوات	سوات
स्वान्ज़ी	سْوانْزِی	سوانزی
स्वीडन	سْوِیْڈن	سویڈن
हनोई	ہنوْئِی	ہنوئی
हरा	ہرا	ہرا
हरारे	ہرارے	ہرارے
हरियाणवी	ہرِیانوِی	ہریانوی
हर्ट्ज़	ہرْٹْز	ہرٹز
हल	ہل	ہل
हल्दी	ہلْدِی	ہلدی
हल्द्वानी	ہلْدْوانِی	ہلدوانی
हवाई	ہوائِی	ہوائی
हवाना	ہوانا	ہوانا
हाइनान	ہائنان	ہائنان
हाथ	ہاتھ	ہاتھ
हाथी	ہاتھِی	ہاتھی
हारबिन	ہاربِن	ہاربن
हारमोनियम	ہارموْنِیم	ہارمونیم
हावड़ा	ہاوڑا	ہاوڑا
हिन्दी	ہِنْدِی	ہندی
हिरण	ہِرن	ہرن
हिसार	ہِسار	ہسار
हीरा	ہِیْرا	ہیرا
हूनान	ہُوْنان	ہونان
हेग	ہیْگ	ہیگ
हेटौडा	ہیْٹَوْڈا	ہیٹوڈا
हेनान	ہیْنان	ہینان
हेसे	ہیْسے	ہیسے
हैं	ہَیْں	ہیں
होनोलूलू	ہوْنوْلُوْلُو	ہونولولو
होन्शू	ہوْنْشُو	ہونشو
होबार्ट	ہوْبارْٹ	ہوبارٹ
होमर	ہوْمر	ہومر
होली	ہوْلِی	ہولی

# Non-initial अ corresponding `ain in Arabic or Persian loanwords:
जमाअत	جماعَت	جماعت
मअनी	معَنِی	معنی
