aed	dirham
afn	afghani
all	lek
amd	dram
ang	gulden
aoa	kwanza
ars	peso
aud	dollar
awg	florin
azn	manat
bam	mark
bbd	dollar
bdt	taka
bgn	lev
bhd	dinar
bif	frank
bmd	dollar
bnd	dollar
bob	boliviano
brl	real
bsd	dollar
btn	ngultrum
bwp	pula
byr	roebel
bzd	dollar
cad	dollar
cdf	frank
chf	frank
ckd	dollar
clp	peso
cny	yuan
cop	peso
crc	colón
cuc	peso
cup	peso
cve	escudo
czk	kroon
djf	frank
dkk	kroon
dop	peso
dzd	dinar
egp	pond
ehp	peseta
ern	nakfa
etb	birr
eur	euro
fjd	dollar
fkp	pond
gbp	sterling
gel	lari
ggp	pond
ghs	cedi
gip	pond
gmd	dalasi
gnf	frank
gtq	quetzal
gyd	dollar
hkd	dollar
hnl	lempira
hrk	kuna
htg	gourde
huf	forint
idr	rupiah
ils	sikkel
imp	pond
inr	rupee
iqd	dinar
irr	rial
isk	króna
jep	pond
jmd	dollar
jod	dinar
jpy	yen
kes	shilling
kgs	som
khr	riel
kmf	frank
kpw	won
krw	won
kwd	dinar
kyd	dollar
kzt	tenge
lak	kip
lkr	rupee
lpb	pond
lrd	dollar
lsl	loti
lyd	dinar
mad	dirham
mdl	leu
mga	ariary
mkd	denar
mmk	kyat
mnt	tögrög
mop	pataca
mro	ouguiya
mur	rupee
mvr	rufiyaa
mwk	kwacha
mxn	peso
myr	ringgit
mzn	metical
nad	dollar
ngn	naira
nio	córdoba
nok	kroon
npr	rupee
nzd	dollar
omr	rial
pab	balboa
pen	sol
pgk	kina
php	peso
pkr	rupee
pln	złoty
pyg	guarani
qar	riyal
ron	leu
rsd	dinar
rub	roebel
rwf	frank
sar	riyal
sbd	dollar
scr	roepee
sdg	pond
sek	kroon
sgd	dollar
shp	pond
sll	leone
sos	shilling
srd	dollar
ssp	pond
std	dobra
syp	pond
szl	lilangeni
thb	baht
tjs	somoni
tmt	manat
tnd	dinar
top	paʻanga
try	lira
ttd	dollar
tvd	dollar
twd	dollar
tzs	shilling
uah	hryvnia
ugx	shilling
usd	dollar
uyu	peso
uzs	som
vef	fuerte
vnd	đồng
vuv	vatu
wst	tala
xaf	frank
xag	fynons silver
xau	fynons goud
xcd	dollar
xof	frank
xpd	fynons palladium
xpf	frank
xpt	fynons platinum
yer	rial
zar	rand
zmw	kwacha
