aed	dirhams
afn	afghani's
all	leks
amd	drams
ang	guldens
aoa	kwanzas
ars	peso's
aud	dollars
awg	florins
azn	manats
bam	mark
bbd	dollars
bdt	takas
bgn	levs
bhd	dinars
bif	frank
bmd	dollars
bnd	dollars
bob	boliviano's
brl	real
bsd	dollars
btn	ngultrums
bwp	pulas
byr	roebels
bzd	dollars
cad	dollars
cdf	frank
chf	frank
ckd	dollars
clp	peso's
cny	yuan
cop	peso's
crc	colóns
cuc	peso's
cup	peso's
cve	escudo's
czk	krone
djf	frank
dkk	krone
dop	peso's
dzd	dinars
egp	ponde
ehp	pesetas
ern	nakfas
etb	birrs
eur	euro's
fjd	dollars
fkp	ponde
gbp	sterling
gel	lari's
ggp	ponde
ghs	cedi's
gip	ponde
gmd	dalasi's
gnf	frank
gtq	quetzals
gyd	dollars
hkd	dollars
hnl	lempiras
hrk	kunas
htg	gourdes
huf	forints
idr	rupiahs
ils	sikkels
imp	ponde
inr	rupees
iqd	dinars
irr	rial
isk	krónas
jep	ponde
jmd	dollars
jod	dinars
jpy	jen
kes	shillings
kgs	soms
khr	riel
kmf	frank
kpw	won
krw	won
kwd	dinars
kyd	dollars
kzt	tenges
lak	kips
lkr	rupees
lpb	ponde
lrd	dollars
lsl	loti's
lyd	dinars
mad	dirhams
mdl	leu's
mga	ariary's
mkd	denars
mmk	kyats
mnt	tögrögs
mop	patacas
mro	ouguiyas
mur	roepee's
mvr	rufiyaa's
mwk	kwachas
mxn	peso's
myr	ringgits
mzn	meticals
nad	dollars
ngn	nairas
nio	córdobas
nok	krone
npr	rupee's
nzd	dollars
omr	rial
pab	balboas
pen	sols
pgk	kinas
php	peso's
pkr	rupee's
pln	złoty's
pyg	guarani's
qar	riyal
ron	leu's
rsd	dinars
rub	roebels
rwf	frank
sar	riyal
sbd	dollars
scr	rupees
sdg	ponde
sek	krone
sgd	dollars
shp	ponde
sll	leone's
sos	shillings
srd	dollars
ssp	ponde
std	dobras
syp	ponde
szl	lilangeni's
thb	baht
tjs	somoni's
tmt	manats
tnd	dinars
top	paʻangas
try	lire
ttd	dollars
tvd	dollars
twd	dollars
tzs	shillings
uah	hryvnias
ugx	shillings
usd	dollars
uyu	peso's
uzs	soms
vef	fuerte's
vnd	đồngs
vuv	vatu's
wst	talas
xaf	frank
xag	fynons silver
xau	fynons goud
xcd	dollars
xof	frank
xpd	fynons palladium
xpf	frank
xpt	fynons platinum
yer	rial
zar	rande
zmw	kwachas
