génesis	genesis
gen.	genesis
exodus	eksodus
ex.	eksodus
eks.	eksodus
levítikus	levitikus
lev.	levitikus
númeri	numeri
num.	numeri
deuteronómium	deuteronomium
deut.	deuteronomium
jos.	josua
rigt.	rigters
rig.	rigters
rut	rut
sam.	samuel
kon.	konings
kron.	kronieke
esra	esra
nehemía	nehemia
neh.	nehemia
est.	ester
job	job
ps.	psalms
spr.	spreuke
pred.	prediker
hoogl.	hooglied
jes.	jesaja
jer.	jeremia
klaagl.	klaagliedere
eségiël	esegiël
eseg.	esegiël
dan.	daniël
hoséa	hosea
hos.	hosea
joël	joël
am.	amos 
obad.	obadja
ob.	obadja
jona	jona
miga	miga
nah.	nahum
hábakuk	habakuk
hab.	habakuk
sefánja	sefanja
sef.	sefanja
hag.	haggai
sagaría	sagaria
sag.	sagaria
maleági	maleagi
mal.	maleagi
matthéüs	matteus
matt.	matteus
mark.	markus
luk.	lukas
joh.	johannes
hand.	handelinge
rom.	romeine
korinthiërs	korintiërs
kor.	korintiërs
galásiërs	galasiërs
gal.	galasiërs
efésiërs	efesiërs
ef.	efesiërs
filip.	filippense
fil.	filippense
kol.	kolossense
thessalonicense	tessalonisense
thess.	tessalonisense
tess	tessalonisense
timótheüs	timoteus
tim.	timoteus
tit.	titus
filémon	filemon
filem.	filemon
heb.	hebreërs
jak.	jakobus
pet.	petrus
jud.	judas
openb.	openbaring
op.	openbaring
